1111111111111111111111111111111
1111000101111100001100010101011
1110000011110000111100000011101
111000E000000CC0000000000000001
111111100000C000001111111111111
1111111111111111111111111111111