111111111111111
1P0000000000001
1C00000000000E1
111111111111111