1111111111111111111111111111111
1111000001111100001100010101011
11P0000011110000111100000011101
11E0000000000000000000000000001
111111100000C000001111111111111
1111111111111111111111111111111